0000000000
1111000000
0000000100
0011100100
0000000100
0010000100
0000100100
0000100100
0111100000
0000000000
